1111111111
1111111111
1000000011
1011111010
0000000000
1011111010
1011111011
1011111011
1011111011
1000000011