1011011000
0000001000
0000001011
1011011011
1011000011
1010000011
1010011011
0010010011
0011010000
1011011000